#
# 0 D room0.txt 1 key2
#
#
WWWW0WWWWW
W      s W
W        W
W m      W
W   W    W
W   W  WWW
W        W
W     T  W
W        W
WWWWWWWWWW